NO textures/wood_strips.xpm
SO textures/wood.xpm
WE textures/wood_box.xpm
EA textures/rocks.xpm

C 155,154,100
F 47,70,65

111111111111111111111111111111111
111111111000000000110000000000001
111111111011000001110000000000001
111111111001000000000000000000001
1111111110110000011100000000000001
100000000011000001110111100011111
111101111111110111000000100011111
111101111111110111010100100011111
110000001101010111000000100011111
100000000000000011000000100011111
100000000000000011010100100011111
11000001110101011111011110N011111
111101111111010111011110100011111
111111111111111111111111111111111