11111111111111111111111111111111111
    11111111111111100000000000000000010101
11111111111111111111111111111111111111111
1111111111111111    1111111111111111111111
111111111000000000000011111111111111111111
1111110000000000000000000000P00000000000000001
1111111110101011001010101010101010101010101010
101111111111111111101011111110111111101001111111
11111011110101111101101010111010111101111011010111
111111111110101011111111111111111111111111111111dde3esdwxcdcdw