NO textures/wood_strips.xpm
SO textures/wood.xpm
EA textures/rocks.xpm
WE textures/wood_box.xpm

F 90, 90,90
C 97, 85, 127


      1111111       1       111111111111111111111
      1001         111111111111100000000000001111111111111
      1001111      1111111111000000000000000000111000000001
      1110111      1000000110000000000000000000000000000001
        111        1000000000000000000000000000111000000001
11111111000111111 1110111111111111110111111111111 1111111111
1000001100000000010000001          101
1000000000000000000000001111111111111111111111111
1000001100000000110000000100000000000000000000001
1111111100000000110000001110000000000000000000001
1000001 1111111111111111  10000000000000000000001
1000001 10000000000001    11111101000100000000001
1000001110000000000001    10000001000100000000001
1000000000000000000001    10000001000100000000001
1000001110000000000001    11111101000100000000001
1000001 10000000000001    10000001000100000000001
1000001 11111111111111    10000001111100000000001
1000001                   10000000000000000000001
1000001                   10000000000000000000001
1000001                   100000000S0000000000001
1000001                   11111111111111111111111
1000001   
10000011111111111111111111111111111111111
10000011000000000000001100000001100000001
10000000000000000000000000000000000000001
10000011000000000000001100000001100000011
11111111111111111111111111111111111111111

