NO textures/wood_strips.xpm







EA textures/rocks.xpm



SO textures/rocks.xpm

C     100   ,   1   ,     20

WE textures/wood_box.xpm


F 70,70       ,     65
1
11111111111111111111111111111                11111
1000000000010000000000001111111111111111111111111
1000001100001000110000000100000000000000000000001
1111111100000000110000001110000000000000000000001
1000001 1111111011111111  10000000000000000000001
1000001 10000000000001    11111101000100000000001
1000001110000000000001    10000001000100000000001
1000000000100000000001    10000001000100000000001
1000001110000000000001    11111101000100S00000001
1000001 10000000000001    10000001000100000000001
1000001 11111111111111    10000001111100000000001
1000001                   10000000000000000000001
1000001                   10000000000000000000001
1000001                   10000000000000000000001
1000001                   11111111111111111111111
1000001   
10000111111111111111111111111111111111111
10000011000000000000001100000001110000001
10000000000000000000000000000000000000001
10000011000000000000001100000001100000011
11111111111111111111111111111111111111111